****************
*         *   E*
*    S    *  ***
*    *    *    *
*    *    *    *
*    *    *    *
*    *         *
****************
